F 139,99,58
C 171,154,137

NO textures/north.xpm
SO textures/south.xpm
EA textures/east.xpm
WE textures/west.xpm

1111111111111111111
1001001001001001001
1001001001001001001
1001001001001001001
1001001000001001001
100000000S000000001
10000111111N11000001
1111000000000001111
1000000101010000001
1111111111111111111