111111111       1111111111
1001001001001001001
1001001001001001001
1001001001001001001
               1001001000001001001
100000000S000000001
10000111111N11000001
1111000000000001111
1000000101010000001
11111111111