1111111111111111111
1001001001001001001
1001001001001001001
1001S01000001001001
1001001000001001001
1000000000000000001
1000011111111000001
1111000000000001111
1000000101010000001
1111111111111111111