C 5,236, 255
F 139,99,58


WE textures/west.xpm
NO textures/north.xpm
SO textures/south.xpm
EA textures/east.xpm

1111111111111111111  111
1001001001001001001  101
1001000001001001001  111
1001000101001001001
1001000000010001001
1000000E00000000001
1000011101111000001  
1111000000000001111
1000000101010000001
1111111111111111111
1       1     1