F 139,99,58
C 0,236,255

NO textures/sprt1.xpm
SO textures/south.xpm
EA textures/east.xpm
WE textures/west.xpm

1111111111111111111
1001001001001001001
1001000001001001001
1001000001001001001
1001000000010001001
1000000W00000000001
1000011101111000001
1111000000000001111
1000000101010000001
1111111111111111111