F 139,99,58
C 171,154,137

NO textures/north.xpm
SO textures/south.xpm
WE textures/east.xpm
EA textures/west.xpm

1111111111111111111
1001001001001001001
1001000001001001001
1001000001001001001
1001000000010001001
10000000E0000000001
1000011101111000001
1111000000000001111
1000000101010000001
1111111111111111111