F 139,99,58
C 171,154,137

NO textures/north.xpm
SO textures/south.xpm
WE textures/east.xpm
EA textures/west.xpm

1111111111111111111
1000110110000000001
1000000000000000001
1000000000000000001
100000N000000000001
1000000000000000001
1000000000000000001
1000000000000000001
1000000000000000001
