F 139,99,58
C 0,236,255

NO textures/north.xpm
SO textures/south.xpm
EA textures/east.xpm
WE textures/west.xpm

1111111111111111111
1000110110000000001
1000000000000000001
1000001000000000001
100001N100000000001
1000001000000000001
1000000000000000001
1000000000000000001
1000000000000000001
