1111111111111111111
1000110110000000001
1000000000000000001
1000000000000000001
100000N000000000001
1000000000000000001
1000000000000000001
1000000000000000001
1000000000000000001
1111111111111111111