1111111111111111
1001001001001001
1001000001001001
1001000N01001001
1001000000010001
1000000010000001
1000011101111001
1111000000000001
1000000101010001
1111111111111111