F 139,99,58
C 0,236,255

NO textures/north.xpm
SO textures/south.xpm
EA textures/east.xpm
WE textures/west.xpm

1111
1001
10S1
1111