F 139,99,58

NO textures/north.xpm
SO textures/south.xpm

EA textures/east.xpm
WE textures/west.xpm
C 0,236,255

11111
1001111
10S0001
1111111
1111