F 139, 99, 58  4
C 0,236,255

NO textures/north.xpm
SO textures/south.xpm
EA textures/east.xpm
WE textures/west.xpm

        1
       111
      11011
     1100011
    1100N011
   11000100111
  1111111111111