F 139,99,58
C 171,154,137

NO textures/north.xpm
SO textures/south.xpm
EA textures/east.xpm
WE textures/west.xpm

        1
       101
      1001
     10S001
    10010011
   1111111111